ኮሚሺኒቸቲ	komishinichatti
ጎርሳ	gorsaa
ኦል	ol
ኣና	aanaa
ዲሞተ	dhimmoota
ሚዲያፊ	miidiyaafi
ኮሙኒኬሺኒ	komunikeeshinii
ኦብቦ	obbo
ኣሮን	aaroon
ማሾ	maashoo
ብብጭቲ	bbctti
አከ	akka
ሂመን	himan
ሀሌላ	haleellaa
ዊጠተ	wiixata
ራወቴን	raawwateen
ሉቡን	lubbuun
ነሞተ	namoota
ደርቤረ	darbeera
ሀሌላን	haleellaan
ኩኒስ	kunis
ቤኒሻንግል	benishaangul
ግሙz	gumuz
ኣና	aanaa
ዲባጢ	dibaaxii
መጋላ	magaalaa
ጢቆ	xiqqoo
ዳለቲ	daalattii
ጄዳሙቲዳ	jedhamuttidha
ኦብቦ	obbo
ማሾን	maashoon
አከ	akka